{
    "board": [
        "WWWWWWWWWWWWWWWWWWWWWWWWWWWWWWWWWWWWW",
        "WEEEEEEEEEEEEEEEEEEEEEEEEEEEEEEEEEEEW",
        "WEEEEEEEEEEEEEEEEEEEEEEEEEEEEEEEEEEEW",
        "WEEEEEEEEEEEEEEEEEEEEEEEEEEEEEEEEEEEW",
        "WEEEEEEEEEEEEEEEEEEEEEEEEEEEEEEEEEEEW",
        "WEEEEEEEEEEEEEEEEEEEEEEEEEEEEEEEEEEEW",
        "WEEEEEEEEEEEEEEEEEEEEEEEEEEEEEEEEEEEW",
        "WEEEEEEEEEEEEEEEEEEEEEEEEEEEEEEEEEEEW",
        "WEEEEEEEEEEEEEEEEEEEEEEEEEEEEEEEEEEEW",
        "WEEEEEEEEEEEEEEEWWWWWEEEEEEEEEEEEEEEW",
        "WEEEEEEEEEEEEEEEWWWWWEEEEEEEEEEEEEEEW",
        "WEEEEEEEEEEEEEEEWWWWWEEEEEEEEEEEEEEEW",
        "WEEEEEEEEEEEEEEEWWWWWEEEEEEEEEEEEEEEW",
        "WEEEEEEEEEEEEEEEEEEEEEEEEEEEEEEEEEEEW",
        "WEEEEEEEEEEEEEEEEEEEEEEEEEEEEEEEEEEEW",
        "WEEEEEEEEEEEEEEEEEEEEEEEEEEEEEEEEEEEW",
        "WEEEEEEEEEEEEEEEEEEEEEEEEEEEEEEEEEEEW",
        "WEEEEEEEEEEEEEEEEEEEEEEEEEEEEEEEEEEEW",
        "WEEEEEEEEEEEEEEEEEEEEEEEEEEEEEEEEEEEW",
        "WEEEEEEEEEEEEEEEEEEEEEEEEEEEEEEEEEEEW",
        "WEEEEEEEEEEEEEEEEEEEEEEEEEEEEEEEEEEEW",
        "WWWWWWWWWWWWWWWWWWWWWWWWWWWWWWWWWWWWW"
    ],

    "constants": {
        "max_cycles": 300,
        "max_health": 3,
        "wall_breaker_cooldown": 12,
        "wall_breaker_duration": 6,
        "wall_score_coefficient": 1,
        "area_wall_crash_score": -50,
        "my_wall_crash_score": -100,
        "enemy_wall_crash_score": -150
    },

    "agents": {
        "Blue": {
            "position": {"x": 1, "y": 1},
            "direction": "Right"
        },
        "Yellow": {
            "position": {"x": 35, "y": 20},
            "direction": "Left"
        }
    }
}
